AAAAHIAAAAAAAAAAAAAAAAAAAAAAAAAAAAAAAAAAAAAAAAAAAAAAAAAAAAAAAAAAAAAAAA
.....................................................................A
.....................................................................A
....................................................DED..............A
................B.........C..........................................A
................B..............................DED...................A
................BBBB......B..........................................A
................B...B.....B...............DED........................A
................B...B.....B..........................................A
.P..............B...B.....B..........DED.................FG..........A
.........................................................HI..........A
........................Y...................Y......Y.....HI..........A
.........................................................HI..........A
AAAAAAAAAAAAAAAAAAAAAAAAAAAAAAAAAAAAAAAAAAAAAAAAAAAAAAAAAAAAAAAAAAAAAA